111111111111111
100011000000001
1000001000EC001
10000001100C001
10000P0000000E1
111111111111111
