111111111111111
1000K0000000001
1001001010EC001
10000001000C001
10000P000000001
111111111111111
