1111111111111111111111111111111
10001100000000010C0110000000011
10000010000C0001000C1100000K011
10000001100C0000E00C11000010001
10000001100C0001000C00010001001
10000001100C000000C001000000001
10000P0000000011000000000000101
1111111111111111111111111111111
