1111111111111111111111111111111
1000000000000000000000000000001
1000000000010001E00C00000C00C01
10000000000C000000C000000100101
10000001000C0000000000000000001
10000000000C000000000C000000001
10000P00000000000000000000K0001
1111111111111111111111111111111
