1111111111111111111111111111111
1000000000000000000000000000001
1000000000000000000C00000C00001
10000000000C0000E0C000000100001
10000001000C0000000000000000001
10000000000C0000000000000000001
10000P00000000000000000000K0001
1111111111111111111111111111111
