111111111111111111111111111111111111111111111
10001100000000010C011000000001100011001000001
10000010000C0001000C1100000001100000100110001
10000001100C0000E00C1100100000000000100001001
10000001100C0001000C0000000001100000100110001
10000001100C000000C00100000000100000001000K01
10000P000000001100000000000001100000100000001
111111111111111111111111111111111111111111111
