1111111111111111111111111111111
10001100000000010C0110000000011
10000010000C0001000C11000000011
10000001100C0000E00C11000010001
10000001100C0001000C00010001001
10000001100C000000C001000000011
10000P00000000110000000000001K1
1111111111111111111111111111111
