1111111111111111111111111111111
10001100000000010C0110000000011
10000010000C0001000C00000100011
10000001100C0000E00000000000001
10000001100C0000000000000000001
10000001100C000000000000K000001
10000P0000000011000000000000001
1111111111111111111111111111111
